15 15
.....XXXXX.....
GXXX.......XXXG
.X...XX.XX...X.
.X.X.G...G.X.X.
.....XX.XX.....
X.X.XX...XX.X.X
X.X....X....X.X
X.XXXX.X.XXXX.X
X.X....X....X.X
X.X.XX...XX.X.X
.....XX.XX.....
.X.X.......X.X.
.X...XX.XX...X.
.XXX...S...XXX.
.....XXXXXK...T
